便塊除去	摘便
アルツハイマ-認知症	アルツハイマー型認知症
熱傷（背部）	背部熱傷、程度不明（部位を限定しない）
2015.8.12骨盤-その他-前立腺癌	前立腺癌
口のにがみ	苦味
軽度呼吸困難感	呼吸困難
両足関節偽痛風	偽痛風
内痔核出血	痔出血
背部皮脂欠乏性湿疹	皮脂欠乏性湿疹
左側頭葉出血	脳出血
肩凝症	肩こり
がん性疼痛	癌疼痛
脊髄管狭搾症	脊柱管狭窄症
口唇ヘルペスの悪化	口唇ヘルペス
死亡（腎細胞癌の増悪）	腎細胞癌
口が苦い	苦味
肝癌	肝癌
好中球↓	好中球数減少
第３指切傷	指の損傷ＮＯＳ
急性虫垂炎（１４才時手術）	急性虫垂炎
膀胱からの出血	膀胱出血
リンパ郭清	リンパ節郭清
閉塞性大動脈硬化症	閉塞性動脈硬化症
喀痰による閉塞	無し
心戻細動	心房細動
肺結亥	肺結核
くり返すシャント血栓症	シャント血栓症
２次性副甲状腺機能亢進症（ｉｎｔａｃｔＰＴＨ上昇）【ｉｎｔａｃｔＰＴＨ上昇】	ＰＴＨ増加
プラザキサによる腎機能悪化疑い	腎機能悪化
慢性血栓塞栓性肺高血圧症の増悪	慢性血栓塞栓性肺高血圧症
下肢浮腫（両足）	足部浮腫
心房頻拍	心房頻脈
頚部出血（頚部リンパ節からの出血。頚部リンパ節は記載あり）	リンパ節出血
両側総腸骨動脈瘤術後	腸骨動脈瘤
急性肺炎（重篤）	急性肺炎
永久ペースメーカー挿入	恒久的心臓ペースメーカー植込み
７２歳腹部大動脈瘤術後	大動脈瘤修復
ＨＤＬコレステロールの上昇	ＨＤＬコレステロール増加
薬物性紅皮症	紅皮症様薬疹
左眼底出血	眼底出血
手足皮膚症状【手足皮膚反応】	手足皮膚反応
僧帽弁逆流閉鎖不全	僧帽弁閉鎖不全症
手・足症候群	手足症候群
右甲状腺腺腫悪化	甲状腺腺腫
慢性多発性関節リウマチ	関節リウマチ
手足皮膚痛	皮膚疼痛
右足爪白癬症	爪白癬
右肘打撲	肘の挫傷
細菌性眼内炎（右眼）	感染性眼内炎
左後頭葉脳梗塞	脳梗塞
右正中神経損傷	正中神経損傷
異石灰化腫瘤【腫瘍状石灰沈着症】	腫瘍状石灰沈着症
左横静脈洞血栓症	横静脈洞血栓症
右陰嚢水腫	陰嚢水瘤
下壁誘導におけるST上昇	ＳＴ上昇
心弁置換手術	心臓弁置換
腹水増悪	腹水
HOTFLASH	ほてり
冠動脈スパズム	冠動脈攣縮
胆石症術後	胆石摘出
母趾圧痛	足指痛
突発性腹痛	腹痛
慢性蕁麻疹（全身）	慢性蕁麻疹
黒色液体の嘔吐	暗色吐物
消化管症状	胃腸症状ＮＯＳ
頭部挫創	挫創
重症呼吸不全	呼吸不全
２５才腸閉塞手術	腸閉塞
心内血栓（一過性）	心臓内血栓
左前腕の重圧感	四肢重感
聴力（聴力低下）	聴力低下
穿刺部出血	穿刺部位出血
CLASSSIC CNV	脈絡膜血管新生
ＡＳＤ（心房中隔欠損症）	心房中隔欠損症
平成１２年１１月７日ゆ着はく離術腸管、大網、左卵巣子宮内膜症性のう胞のゆ着	卵巣子宮内膜症
胃粘膜のヒダ状白色肥厚	胃粘膜ひだ肥厚
壊死性リンパ節炎	無し
近視性脈絡膜新生血管	近視性脈絡膜血管新生
鼻出血 発現日不明	鼻出血
下肢ＤＶＴ	下肢深部静脈血栓症
右腎出血性のう胞うたがい	腎嚢胞出血
幼少時に下痢で入院その時輸血を受ける	下痢
左足がだるい	筋肉疲労
咽頭が苦しい	咽頭絞扼感
手の甲の腫脹	手の腫脹
睾丸腫瘍	精巣新生物
イライラしやすい	易刺激性
足痛	足部痛
消化管出血疑い	消化管出血
左第４指痛	手指痛
左人工骨頭置換術後	骨手術
右下腿皮下血腫	皮下血腫
耐糖能悪化	耐糖能障害
喉のかわき	咽頭乾燥
慢性肝炎（軽度、肝硬変は無い）	慢性肝炎
ＰｏｒｔａｌＨｙｐｅｒｔｅｎｓｉｖｅＧａｓｔｒｏｐａｔｈｙ	門脈圧亢進性胃障害
肝臓Γ線療法	肝臓γ線療法
甲状腺悪性リンパ腫	悪性リンパ腫
蓄膿症手術（２５才）（副鼻腔炎）	副鼻腔炎
グルコース耐性境界型	耐糖能境界型
陰部の不快感	性器不快感
死亡（敗血症）	敗血症
月経の出血量が少ない	過少月経
超急性期脳梗塞	脳梗塞
早期慢性関節リウマチ	関節リウマチ
閃輝性硝子体融解	閃輝性融解
月経が多い	月経過多
熱傷（右第Ⅱ～第Ⅳ指）	母指を除く、２指以上に及ぶ熱傷、程度不明
MALIGNANT MIXED GERM CELL TUMOR	悪性新生物
横行結腸がん	横行結腸癌
心臓-その他(心尖部肥大型心筋症)	肥大型心筋症
全身掻痒症	全身性そう痒症
ＴＧ異常値	トリグリセリド異常
弾撥指（術後）	弾発指解離
噴門癌	噴門の悪性新生物
下腹部痛の増悪（月経時）	月経痛
ＩＮＲ短縮	ＩＮＲ減少
下痢症状	下痢
大腸ポリープ癌術後	大腸癌
続発性後天性低Γグロブリン血症	続発性後天性低γグロブリン血症
舌にウイルス	口腔ウイルス感染
乳腺症（右）	乳腺症
腫瘍からの出血	腫瘍出血
下腿浮腫の増悪	下肢浮腫
高血圧（未治療）	高血圧
目眩	めまい感
尿が白っぽくなった	尿変色
開腹原発巣切除	癌切除
２００３年８月非機能性膵内分泌腫瘍	膵神経内分泌腫瘍
肋骨骨折（左）	肋骨骨折
ＤＭＮ	無し
頸部リンパ節摘出術	リンパ節切除
発赤頭、顔面	皮膚発赤
漿液性網膜色素上皮剥離	網膜色素上皮の漿液性剥離
ＰＢＣ（原発性胆汁性肝硬変症）	原発性胆汁性肝硬変
抗ＨＢＳ抗体陽性	抗ＨＢｓ抗体陽性
腹腔内・縦隔リンパ節転移	リンパ節転移
賢炎	腎炎
両側乳腺症	乳腺症
目の充血	眼充血
包皮のかぶれ	接触皮膚炎
左第二指爪剥離	爪破損
子宮収縮増強	子宮筋収縮亢進
大網ゆ着はく離術	腹膜癒着部切離術
排尿時痛	排尿痛
虫垂切除（１７歳時）	虫垂切除
かゆみ	そう痒
左鎖骨遠位端骨折	鎖骨骨折
頸髄中心性損傷	頚椎部脊髄損傷
右変形性股関節の手術	変形性股関節症
随伴疾患進行ＮＯＳ	随伴疾患進行
子宮筋腫（手術）	筋腫核出術
HCC(肝切除）	肝細胞癌
ＨａｎｄＦｏｏｔ症候群	手足症候群
角膜下出血	角膜出血
起立性調整障害（めまい、ふらつき）	浮動性めまい
発熱（細菌感染症疑い）	無し
透析困難症	無し
便秘ぎみ	便秘
血圧上昇（ＤＢＰ）	拡張期血圧上昇
体の痛み	全身性疼痛
２６才胃潰瘍	胃潰瘍
血清ＴＰ高値	総蛋白高値
冠状動脈炎	冠動脈炎
ブルトン型無ガンマグロブリン血症	ブルトン型無γグロブリン血症
喉の腫れ	咽喉腫脹
ふくらはぎに痛み	ふくらはぎ痛
顔面裂傷、打撲【顔面打撲】	顔の挫傷
・高血圧	高血圧
勃起障害	男性勃起不全
眼瞼異常	眼瞼障害
ＬＤＬコレステロール上昇	ＬＤＬコレステロール増加
気管支喘息増悪	喘息増悪
右腕筋肉痛	局所筋肉痛
内臓逆位	内臓逆位症
乳癌術後	乳癌
打撲症【右顔面および左大腿部】	挫傷
脳卒中，Ｔｙｐｅ：心原性	血栓性脳卒中
出血下血	メレナ
高し血症	高脂血症
吐血（コーヒー残渣様吐血）	コーヒー残渣様吐物
左膝偽痛風	偽痛風
頭頸部-その他(異常なし)	無し
肝障害、肝不全	無し
手先のしびれ右第１指，２指	手指のしびれ感
上半身打撲	挫傷
ヘリコバクターピロリ菌感染症	ヘリコバクター・ピロリ感染
右肺葉間水腫	肺水腫
原発不明癌再発なし	癌
子宮内膜症３４才	子宮内膜症
変形性股関節症手術	変形性股関節症
陰性T（側壁）	陰性Ｔ波
放射線性肺炎	放射線性肺臓炎
大腸炎の疑い	大腸炎
糖尿病（１９９４年）	糖尿病
右下肢静脈血栓	下肢静脈血栓
右拇指切創	指の損傷ＮＯＳ
左眼の視野異常	視野欠損
大腸ポリープ（腺腫）平成１９年２月２６日内視鏡的切除	大腸ポリープ切除
左趾陥入爪の悪化	嵌入爪
緑内症	緑内障
感冒（微熱、鼻汁、咽頭痛）【感冒】	感冒
喉頭違和感	喉頭不快感
不安症	不安
甲状腺機能低下症、治療中、チラーヂン２コ	甲状腺機能低下症
過長月経＋不正出血	無し
皮下出血が気になる	皮下出血
足底部硬化	皮膚硬結
二次性副甲状腺機能亢進症増悪	続発性副甲状腺機能亢進症
結腸憩室出血	出血性結腸憩室
指先の痛み	手指痛
胃が重い	胃重感
抹消神経障害	末梢性ニューロパチー
胃炎の予防	胃炎予防
チョコレートのう腫手術（卵巣チョコレート嚢胞）	卵巣チョコレート嚢胞
去痰【痰】	痰
頭重感,頭痛	頭痛
左痙性麻痺	左側麻痺
消火器症状（胸焼け）	胸やけ
ＡＳＴ異常【上昇】	ＡＳＴ増加
左心室性拡張障害	左室機能不全
骨盤-その他-結腸直腸癌	結腸直腸癌
低リンパ球症	リンパ球数低値
詳細不明のＡＥ	有害事象ＮＯＳ
術後グラフト閉塞	移植血管閉塞
右眼瞼皮膚炎の再発	眼瞼皮膚炎
腹部大動脈閉塞（レリッシュ症候群）	ルリーシュ症候群
骨盤内膿瘍	骨盤膿瘍
陰部のかゆみ	陰部そう痒
高血圧心疾患	高血圧性心疾患
低Ｔ３	トリヨードチロニン低値
ＧＰＴ５４	ＡＬＴ高値
膀胱悪性腫瘍（Ｔａ）（ＴＵＲ－ＢＴ施行）	膀胱の悪性新生物
胆嚢のう胞	胆嚢嚢胞
ｗＡＭＤ（左眼）	湿性加齢黄斑変性
予防（制吐）	嘔吐予防
タン白尿	蛋白尿
自己免疫性肝炎の疑い	自己免疫性肝炎
左手指切断	指切断
治癒・切除不能な進行・再発の結腸・直腸癌	再発結腸直腸癌
左小脳梗塞	小脳梗塞
めまい／ふらつき	浮動性めまい
幼少時に下痢発熱で入院その時輸血を受ける【発熱】	発熱
他院より死亡の連絡があったのみで詳細不明。	死亡ＮＯＳ
胆管癌術後	胆管癌
ＣＲＢＢＢ	完全右脚ブロック
皮膚症状（硬結）	皮膚硬結
右網膜中心静閉塞症	網膜中心静脈閉塞
不整脈の悪化	不整脈
死亡【肺癌】	肺癌
糖尿病神経障害	糖尿病性ニューロパチー
外陰部のかゆみ	外陰部そう痒
肩凝り症	肩こり
第２色盲	２型２色覚
術前・術後滅菌	感染予防
軽労作で増強する動悸症状	動悸増悪
ＯＳＡＳ	閉塞性睡眠時無呼吸症候群
滲出型加齢黄斑変性（ＡＭＤ）	滲出型加齢黄斑変性
筋肉転移	筋転移
ＡＭＹ上昇	アミラーゼ増加
包皮感染	感染性亀頭包皮炎
アレルギーNOS	アレルギーＮＯＳ
Ｓ状結腸癌手術	Ｓ状結腸の悪性新生物
Ｈｃｔ低値	ヘマトクリット低値
発疹（顔面、上肢、下肢）	発疹
手足皮膚症状（抗癌試験）	皮膚症状
皮疹（頭）	限局性発疹
良性頭位性眼振	眼振
尾状核出血	大脳基底核出血
胆石症（５４才時手術）	胆石摘出
プリモビストＥＯＢを投与したが造影効果が弱い	薬効不十分
時に不整脈	不整脈
乳房緊満（両側）	乳房緊満
右片麻痺（不全）	不全片麻痺（右）
両下肢しびれ感	下肢のしびれ感
過敏症素因（花粉症）	花粉症
動脈血二酸化炭素分圧上昇	炭酸ガス分圧上昇
シャント部穿刺痛【静脈穿刺部痛】	静脈穿刺部位疼痛
深部静脈血栓塞栓症	深部静脈血栓症
体幹・下肢筋力低下	筋力低下
大腸がん（Ｏｐｅ後再発なし）	大腸癌
腸管の蠕動運動の低下	腸管蠕動低下
第13因子欠乏症	第ＸＩＩＩ因子欠乏症
頚のはり	頚部硬直
右腎癌、手術日（平成１２年１２月２７日）	腎癌
体がカーッと暑くなる	熱感
腰筋痛症	局所筋肉痛
血管外性細胞腫【血管周囲細胞腫】	血管周囲細胞腫
白内障手術（IOL）(右眼)	白内障手術
ＶｉｔＣ欠乏症	ビタミンＣ欠乏
ｉ－ＰＴＨ↑	ＰＴＨ増加
変形性膝関節症による左膝痛	無し
中心性漿液性脈絡膜網膜症	中心性漿液性網膜症
手術の実施（ポリペクトミー）	ポリープ切除
皮膚のかゆみと発疹	そう痒性皮疹
左腎嚢胞内出血	腎嚢胞出血
月経前症候群の予防のためにヤーズを処方された	適応外使用
生殖器・尿路:膀胱癌術後	膀胱癌
父：高血圧	心血管障害の家族歴
こむら返り(腓腹筋痙攣)	こむら返り
光感作されたＮＯＳ	光感作された
左下腿血栓性静脈炎	下肢血栓性静脈炎
帝王切開術３回	帝王切開
足がふらつく	無し
脳静脈血栓症（CVST）	大脳静脈血栓症
右下肢浮腫増悪	末梢性浮腫増悪
ポリペクトミー	ポリープ切除
胃癌（Ｓｔａｇｅ２ｃ）幽門側胃切除	胃癌第２期
喉から血が出た	咽頭出血
食道の違和感	食道不快感
先天性胆道拡張症	先天性胆管拡張症
リンの値が上がってきた	リン酸塩増加
体が暖くなってくる感じ	温感
糖尿病２型インシュリン投与	２型糖尿病
右網膜剥離（術後）	網膜剥離修復
ａｐｐｅｔｉｔｅｌｏｓｓ	食欲低下
左副腎腫瘍摘出	副腎新生物
緑膿菌菌血症	シュードモナス性菌血症
癌性疼痛の悪化	癌疼痛
卵母細胞提供者	卵子提供者
ビリルビン↑	ビリルビン増加
１才背部熱傷	背部熱傷、程度不明（部位を限定しない）
腰部椎間板ヘルニア手術	脱出椎間板修復
背部放射線皮膚炎	放射線性皮膚炎
子宮体部明細胞腺癌	子宮癌
胃ポリープ切除術	胃ポリープ切除
マイクロブリーディング（左前頭葉）	脳微小出血
紅潮	潮紅
残肝部位からの出血	肝出血
子宮筋腫（子宮摘出）	筋腫核出術
趾紅斑	下腿紅斑
足趾真菌症	皮膚真菌症
脱出（紛失）【IUD脱出】	ＩＵＤ脱出
人工心肺	心肺バイパス
ふくらはぎがつった	こむら返り
発赤（顔）	顔面発赤
右前頭葉血腫	脳血腫
心房内血栓症	心房血栓症
陳旧性脳出血	脳出血
皮下脂肪織炎	脂肪織炎
酔った感じ	酩酊感
腰椎狭窄	腰部脊柱管狭窄症
ミレーナ挿入後の頻繁な痙攣	下腹部仙痛
慢性歯周炎の悪化	慢性歯周炎
右腎腫瘍術後	腎腫瘍摘除
喀痰分泌増加	喀痰増加
てんかん大発作	大発作てんかん
下肢ツリ【筋痙攣】	下肢痙攣
皮疹（手、足、頭皮）	皮疹
リパーゼ・アミラーゼ高値	無し
鼻血（微量）	鼻出血
唇の皮が毎日むける	口唇上皮剥脱
原発性肺がん	肺癌
卵巣子宮内膜症嚢胞	卵巣子宮内膜症
シャント閉塞時	シャント閉塞
ｐｏｓｔＰＣＩ【経皮的冠動脈形成術】	経皮的冠動脈形成
口腔内アフタ	口腔アフタ
持続的尿潜血	尿潜血陽性
高Ｃａ血症疑いにて造影ＣＴ検査	高カルシウム血症
腫瘍内出血	腫瘍出血
嘔気胃部不快感	無し
サイログロブリン値増加	サイログロブリン増加
血圧値上昇	血圧上昇
左橈骨遠位端粉砕骨折	橈骨骨折
過敏腸症	過敏性腸症候群
２００８２／２０副腎摘除	副腎摘除
骨盤内局所転移	骨盤転移
舌の違和感	舌の異常な感覚
左尿管転移	尿管癌
糖尿病（投薬なし）	糖尿病
右卵巣腫瘍摘出（良性腫瘍）	卵巣良性腫瘍
ＣＫ－ＭＢ上昇	クレアチンキナーゼＭＢ増加
内服３０分後嘔吐	嘔吐
白内症	白内障
左口角膨隆感	口唇腫脹
乳腺のう胞症	乳房嚢胞
胃の痛み	胃痛
Ｃｌ低下	クロール減少
尿蛋白強陽性化	尿蛋白陽性
慢性腎臓症	慢性腎臓病
左足第３趾痛	足指痛
全身皮膚掻痒	全身性そう痒
好酸球値異常	好酸球数異常
多発性出血性脳梗塞	出血性脳梗塞
高血圧（６６才）	高血圧
細胞診のための出血	処置による出血
右網膜中心静脈閉塞	網膜中心静脈閉塞
右半身しびれ	片側感覚鈍麻
肩が痛い	肩痛
胸部大動脈瘤ステント	胸部大動脈瘤修復
中性脂肪値上昇	トリグリセリド増加
猫アレルギー	ネコアレルギー
急性胃腸炎の疑い	急性胃腸炎
ＴＢｉｌ増加	総ビリルビン増加
悪寒戦慄	悪寒
低Ｆｅ血症	低鉄血症
口唇炎（口角が切れた）	口角口唇炎
虚血性心疾患(詳細不明1996年)	虚血性心疾患
低カリウム性アルカローシス	低カリウム血性アルカローシス
左第２足指皮膚潰瘍	皮膚潰瘍
両膝変形性関節症	変形性膝関節症
膀胱Ｋ	無し
非Ｂ非Ｃ型肝硬変	肝硬変
亜鉛欠乏症	亜鉛欠乏
一過性の頭痛	一過性頭痛
腹部大動脈瘤切迫破裂	腹部大動脈瘤、破裂性
前立腺癌の為の化学療法	前立腺癌
左尺骨の複雑骨折	尺骨骨折
顔面皮膚乾燥	皮膚乾燥
肝動脈化学塞栓療法（ＴＡＣＥ）	経カテーテル動脈化学塞栓術
粉瘤二次感染	感染性粉瘤
大腿静脈血栓（産褥5日目）	産褥期静脈血栓症
より浮腫みやすくなった	浮腫
心原性出血性脳塞栓症	出血性脳梗塞
ペースメーカ	心臓ペースメーカー挿入
膿疱（手、足）	膿疱性皮疹
ワーファリンとの相互作用	薬物相互作用
高クロール【高クロール血症】	高クロール血症
好中球桿状球核球増多	杆状核好中球数増加
下肢静脈ＣＴ	ＣＴスキャン
脳梗塞（右視床）	視床梗塞
胃潰瘍(術後）	胃潰瘍外科手術
脱毛は有害事象とせず	無し
右大腿部腫瘤	下肢腫瘤
肝不全症状	肝不全
梗塞【詳細不明】	梗塞ＮＯＳ
血栓・塞栓症	血栓塞栓症
両)びまん性表層角膜炎	びまん性表層角膜炎
薬剤性肺障害	肺障害
透析困難症【冷汗】	冷汗
喘息妹	家族性危険因子
ＤＭ性末梢神経障害【糖尿病性末梢神経障害】	糖尿病性末梢性ニューロパチー
両足底痛	足部痛
急性骨髄性白血病（ＣＲ）	急性骨髄性白血病
全身倦怠感	全身倦怠
胸壁腫瘤摘出	胸部腫瘤ＮＯＳ
切除不能肝細胞癌	切除不能な肝細胞癌
プラビックスとの相互作用	薬物相互作用
両腎のう胞(後天性腎嚢胞である。)	後天性腎嚢胞
骨盤骨折後遺症	骨盤骨折
45才右乳癌手術	乳癌
腰椎椎間板ヘルニア術后	脱出椎間板修復
貧血の悪化	貧血増悪
２０１０、１２／１１不眠症あり	不眠症
前腕皮下出血	皮下出血
消化管間質腫瘍（食道）	消化管間質性腫瘍
神経障害	ニューロパチー
ＰＴの延長	プロトロンビン時間延長
２００４年Ｓ状結腸癌	Ｓ状結腸の悪性新生物
造影ＰＥＴ／ＣＴ	ＰＥＴ／ＣＴスキャン
無脾症	無脾
低Ｎａ血症（ＳＩＡＤＨ）	無し
子宮内膜症手術（卵巣）	卵巣子宮内膜症
左上下肢打撲症	四肢挫傷
白内障の手術	白内障手術
腸間膜動脈閉塞、消化管穿孔	無し
血栓	血栓症
白血球減少、好中球減少	無し
胃粘膜組織球症	組織球症
骨粗鬆症に伴う疼痛	無し
閉塞性イレウス	機械的イレウス
右冠動脈ＰＴＣＡステント留置	冠動脈ステント装着
左胸部打撲	胸の挫傷
低Ｃａ	カルシウム低値
ＮＨ３上昇	アンモニア増加
爪白癖	爪白癬
脂漏性湿疹（下肢、背中）	脂漏性湿疹
左耳漏	耳漏
中耳炎の悪化	中耳炎
遠位橈尺関節症	骨関節症
胃潰瘍から出血	出血性胃潰瘍
神経因性膀胱前立肥大症	無し
左精巣腫瘍（高位精巣摘除術後）	精巣新生物
結滞、ふらつき	無し
カンジダ膣炎	腟カンジダ
左頚動脈血栓症	頚動脈血栓症
前回悪化したため【RPE（網膜色素上皮）隆起増大】	網膜色素上皮変性
右下顎下部膿瘍	顎膿瘍
左耳の重い感じ	耳不快感
ＣＫ－ＭＢの上昇	クレアチンキナーゼＭＢ増加
外傷性肋骨骨折	外傷性骨折
左中大脳動脈未破裂脳動脈瘤	中大脳動脈瘤
胃炎の悪化	胃炎増悪
２００８年胃癌	胃癌
冠動脈バイパス手術	冠動脈バイパス
結膜炎（左眼）	結膜炎
屈折矯正手術	視力矯正手術
不整脈（しめつけ感、胸部不快感、重苦しさ、動悸）	不整脈
陽子線治療	放射線療法
右肝癌	肝癌
慢性じんま疹	慢性蕁麻疹
腫瘍融解症候群	腫瘍崩壊症候群
右踵部裂傷	足裂傷
嘔吐下痢症【下痢症】	下痢
ヨードアレルギー	ヨウ素アレルギー
脊髄炎（感染なし）	非感染性脊髄炎
血小板数増多	血小板数増加
胸部、背中のかゆみ	そう痒
右手背部皮下出血	皮下出血
肛門拡張ＮＯＳ	肛門拡張
ウイリアムス症候群	ウィリアムス症候群
二次性副甲状腺機能亢進の悪化	続発性副甲状腺機能亢進症
分化型甲状腺癌（乳頭癌）	乳頭様甲状腺癌
右）結膜炎	結膜炎
手足のつり【筋痙攣】	四肢痙攣
死亡【詳細不明】	死亡ＮＯＳ
ｇａｓｔｒｉｃ ｘａｎｔｈｏｍａ	胃黄色腫
糖尿病（インスリン治療中）	糖尿病
しぶり腹	直腸しぶり
膵頭部仮性嚢胞疑い	膵仮性嚢胞
腎盂腎炎（慢性）	慢性腎盂腎炎
分化型甲状腺癌（低分化癌）	甲状腺低分化癌
心筋梗塞（ＰＣＩ後）	心筋梗塞
足踵角化症	角化症
左肩挙上時の疼痛	肩痛
むかつき	悪心
軽度肝障害	肝障害
認痴症	認知症
微量タンパク尿	蛋白尿
左手関節骨折	手骨折
顔面膨隆疹	限局性蕁麻疹
仮性膵のう胞	膵仮性嚢胞
おむつかぶれ	おむつ皮膚炎
脳梗塞歴あり	脳梗塞
発赤の悪化	発赤
膵頭部嚢胞性腫瘤	膵嚢胞
右肘内出血【皮下出血】	皮下出血
鉄欠乏性貧血進行進行胃がん	無し
ムカムカ感	悪心
血液学的異常	無し
消化器:便秘	便秘
ボディスキャンで筋肉量の増加がなく、脂肪量が上がり続けている	脂肪組織増加
ＳＳＳ	無し
のどのかわき	咽頭乾燥
本態性高血圧	本態性高血圧症
左腎臓摘出術施行	腎摘除
両）増殖前糖尿病網膜症	前増殖糖尿病網膜症
重複症候群	オーバーラップ症候群
高血圧（大動脈解離）	無し
右肘皮下出血	皮下出血
術後疼痛緩和	術後鎮痛法
胃悪性リンパ腫	悪性リンパ腫
ｍＣＮＶ（右眼）	近視性脈絡膜血管新生
末梢神経症	末梢性ニューロパチー
血便（わずかな出血）	血便
組織腫脹ＮＯＳ	組織腫脹
腹部-脾臓-脾血管腫	脾血管腫
女性更年期状態	更年期
尿蛋白高値	尿蛋白増加
敗血症ショック	敗血症性ショック
大腿部膨疹	膨疹
一過性ネフローゼ症候群	ネフローゼ症候群
生理前のお腹の張り	腹部膨満
核崩壊ＮＯＳ	核崩壊
痛風による？	痛風
ＧＰＴ値高値	ＧＰＴ増加
咽頭腫瘍	咽頭新生物
体中が痛い	全身性疼痛
冷え症【末梢冷感】	末梢冷感
ＣＯ中毒	一酸化炭素中毒
嘔気＋複視	無し
大腸癌43歳手術、詳細不明	大腸癌
裂離骨折	剥離骨折
二次性副甲状腺機能亢進症コントロール不良	続発性副甲状腺機能亢進症
糖尿病黄斑浮腫（右眼）	糖尿病性黄斑浮腫
右下肢麻痺	下肢麻痺
高血圧（オルメティック１０ｍｇ×３Ｔ）	高血圧
投与に伴う反応ＮＯＳ	投与に伴う反応
左腰背部痛	背部痛
脈拍が上昇	脈拍増加
左足皮膚潰瘍	皮膚潰瘍
食道癌に対し化学療法	食道癌
挫傷による下肢の出血	外傷性出血
脳動脈瘤（左中大脳動脈）	中大脳動脈瘤
治癒切除不能な進行・再発の結腸直腸癌	再発結腸直腸癌
鬱血性心不全	うっ血性心不全
下行結腸切除	結腸切除
乾燥性角結膜炎	乾性角結膜炎
内視鏡的結腸粘膜切除術	結腸手術
右完全片麻痺	右片麻痺
歯周病の悪化	歯周病
総胆管結石症術後	胆管内胆石除去
子宮筋腫全摘術後	筋腫核出術
膵体部腫瘍	膵新生物
難聴傾向	難聴
左上腕骨顆部開放骨折	開放骨折－上腕骨
骨盤-粘液性嚢胞腺腫	腺腫
四肢・血管・その他:慢性関節リウマチ	関節リウマチ
上顎、下顎骨からの出血	骨出血
左膝血腫	関節血腫
Ｕ－アミラーゼ上昇	尿中アミラーゼ増加
左耳垢塞栓	耳垢栓塞
左足が痛い	足部痛
子宮頸部細菌感染	感染性子宮頚管炎
管状腺腫	腺腫
大型脳底動脈本幹部動脈瘤	脳底動脈瘤
自覚的な暗点拡大	暗点
子供が誤服用	子供の偶発的薬剤摂取
ＨＬの悪化	無し
ＴＧが高い	トリグリセリド高値
関節痛（右膝、右股関節	関節痛
膣の掻痒	腟そう痒
左ソケイ部リンパ節転移	リンパ節転移
冷凍療法	凍結療法
ＣＫ（ＣＰＫ）上昇	血中クレアチンホスホキナーゼ増加
消化器症状（嘔吐）	嘔吐
嚢胞内出血	出血性嚢胞
切開に伴う出血	処置による出血
感染徴候	感染
膵癌R/O	膵癌
尿の黒色着色	尿黒変
肝血管腫（ギ）ＵＳでｍａｓｓｐ／ｏ	肝臓血管腫
足がむくむ	足部浮腫
常性硬腫瘤	腫瘤
右肩打撲後皮下出血	肩の挫傷
腕病的骨折	病的骨折
右乳癌手術後（Ｈ１０．７月）	乳癌
造影剤による紅班	紅斑
左前腕部切創	上肢創傷
消化器症状（胃の違和感）出現の為	胃不快感
肝機能障害２４才時	肝機能障害
内シャント創部痛（術後痛）	切開部位痛
子どもが誤飲	子供の偶発的薬剤摂取
骨盤骨骨折	骨盤骨折
舌尖しびれ感	舌のしびれ感
鶏眼（足）	足の胼胝
ＩＮＲ値の延長	ＩＮＲ増加
痰、咳嗽	無し
慢性湿疹（シャント肢）	慢性湿疹
右肘部発赤	限局性紅斑
食欲低下（不振）	食欲減退
高度伝導障害	伝導障害
高アルカリホスファターゼ症	高アルカリホスファターゼ血症
粘膜症状	粘膜障害
後頭部のもやもや感	もやもや感
胃潰瘍の予防	胃潰瘍予防
肺結かく	肺結核
左頚動脈アテローム硬化症	頚動脈硬化症
ネクサバール再投与での高血圧悪化	高血圧増悪
胸苦	胸内苦悶感
ＨＣＶ関連腎炎	肝炎ウイルス関連腎症
手掌のかさつき	皮膚乾燥
右鼠径部感染症	鼡径部感染
ＮＳＡＩＤ潰瘍	胃潰瘍
Ｃａ低値	カルシウム低値
薬剤性ニューロパチー	ニューロパチー
精神不安	不安
術後せん妄	譫妄
LIPID DISORDER(脂質異常症)	脂質異常症
胆のう腫瘍	胆嚢腫瘍
糖尿病網膜症（単純、両眼）	糖尿病網膜症
左母趾末節骨骨折	母趾骨折
ざ瘡性	ざ瘡
血中リパーゼ値上昇	リパーゼ増加
右手外傷後の疼痛【右手外傷後の疼痛】	外傷後疼痛
僧帽弁狭窄手術後	僧帽弁狭窄症
手の甲の出血	皮膚出血
横紋筋融解	横紋筋融解症
Ｄダイマー値の上昇	フィブリンＤダイマー増加
体幹掻痒感	限局性そう痒
塞栓後症候群	塞栓術後症候群
激しい腰痛	腰痛
重症膵炎	膵炎
前立腺肥大レーザー治療	前立腺肥大
腸内細菌叢異常症	細菌叢異常症
単純疱疹	単純ヘルペス
下気道炎	下気道の炎症
頸動脈ステント留置術	頚動脈ステント挿入
性器出血（子宮内膜細胞診のため）	処置による出血
癲癇	てんかん
皮フ潰瘍悪化	皮膚潰瘍
頭痛の悪化	頭痛増悪
右手第一指痛	母指痛
甲状腺濾胞癌	濾胞性甲状腺癌
ほてり（顔）	顔面のほてり
家族性脂質異常症	脂質異常症
多数歯う蝕	齲歯
結膜出血疑い	結膜出血
尿が紫青色	着色尿
広範脊柱管狭窄症	脊柱管狭窄症
左上下肢痺れ	四肢のしびれ感
耳下腺腫瘍手術	耳下腺腫瘍
爪下出血（左足の指の爪）	爪床出血
後頸部つれ【筋痙攣】	頚部痙攣
カンピロバクター性食中毒	細菌性食中毒
爪下出血	爪床出血
Ｔ４上昇	Ｔ４増加
狭心症（バイパス術後）	狭心症
胃癌（平成１９年７月３日切除）	胃癌
右側胸部打撲	胸の挫傷
ＴＧ↑	トリグリセリド増加
上部消化管出血予防	出血予防
陳旧性視床出血	視床出血
右足踵痛	かかと痛
毛細管出血	毛細血管出血
左腎細胞癌疑い	腎細胞癌
自絞死	過量服薬以外の自殺企図
膝関節血腫	関節血腫
ＨＴ（高血圧）	高血圧
特発性心筋症	心筋症
両糖尿病性白内障	糖尿病性白内障
凝固系検査異常変動（ＰＴ低下、ＡＰＴＴ低下、プロテインＳ低下）	無し
尿酸値高値	尿酸高値
（下痢に伴う）腹痛	無し
背中のはり	背部硬直
Ｈｔ値低下（ヘマトクリット値低下）	ヘマトクリット値低下
歯肉腫脹の悪化	歯肉腫脹
左角膜異物	角膜異物
ＰＭＳ（嘔気、めまい、頭痛）	無し
無尿症	無尿
シャント部の易出血	動静脈瘻部位出血
痰に血が混じる	血痰
誤嚥性びまん性気管支肺炎	誤嚥性肺炎
手足皮膚落屑	皮膚落屑
Ｐ低下（リン低下）	リン酸塩減少
手掌・足底の皮膚の落屑	皮膚落屑
趾潰瘍（左足背，左第ニ・三・五趾）	足の潰瘍
両動脈硬化性眼底	眼底動脈硬化症
皮膚化膿創（先行するインターフェロン注射部位の皮膚化膿創）	注射部位感染
骨ページェット	骨パジェット病
下肢動脈瘤	下肢の動脈瘤
背筋痛	局所筋肉痛
皮膚の硬結	皮膚硬結
Ｔ．Ｂｉｌ値上昇	総ビリルビン増加
皮膚発疹	皮疹
右肩腱板損傷	肩回旋筋腱板損傷
２００３年８月膵非機能性内分泌腫瘍	膵神経内分泌腫瘍
頸髄鞘	脊髄症
右声帯ポリープ	声帯ポリープ
咳込み	咳嗽
慢性じん不全の悪化	慢性腎不全増悪
右眼視野欠損	視野欠損
Ｈｂの低下	Ｈｂ減少
皮膚掻痒の増悪	そう痒症増悪
出血（血尿）	血尿
ＳＶＣ症候群	上大静脈症候群
Ａｌ－ｐ髙値	血中アルカリホスファターゼ高値
膵臓Γ線療法	膵臓γ線療法
慢性肺気腫症	肺気腫症
大腿部の痛み	大腿痛
歯痛（腫張熱感）	無し
月経の欠如	月経欠如
頸椎症	頚椎症
２１才盲腸手術	盲腸手術
無症候性間欠的肉眼的血尿	肉眼的血尿
回腸末端に多数の潰瘍	回腸潰瘍
可逆性後白質脳症	可逆性後白質脳症症候群
ｂｒｏｎｃｈｉｅｃｔａｓｉｓ	気管支拡張症
点状角膜炎	点状角膜炎
「肝不全」による死亡	肝不全
ＡＬ－Ｐの上昇	ＡＬＰ増加
肺癌、脳転移なし	肺癌
反復性扁桃炎	再発性扁桃炎
1度房室ブロック	第一度房室ブロック
覚醒	覚醒状態
右腎細胞癌	腎細胞癌
血液培養でカンジダ	カンジダ検査陽性
内頸動脈狭窄症	頚動脈狭窄
左股関節異所性石灰化症	関節石灰化
頚部腫瘤摘除術	頚部腫瘤
骨悪性腫瘍	骨の悪性新生物
仙骨部潰瘍	皮膚潰瘍
左膝関節症	変形性膝関節症
ヘルニア（鼠蹊部）	鼡径ヘルニア
左眼球結膜下出血	結膜下出血
Ｓ状結腸憩室出血疑い	出血性結腸憩室
顔面部切傷	顔面損傷
新生血管加齢黄斑変性（右眼）	新生血管加齢黄斑変性
末梢神経痛	神経痛
高血圧一時悪化	高血圧増悪
高リン	血中リン増加
左上肢帯状疱疹	帯状疱疹皮膚炎
びらん性湿疹（外陰部）	接触性湿疹
右総腸骨動脈狭窄症	腸骨動脈狭窄
下顎骨髄炎	顎骨髄炎
多発毛のう炎	毛包炎
成人STILL病	成人発症スチル病
母；骨粗鬆症	家族性危険因子
虫垂炎の切除	虫垂炎
過眠傾向	過眠症
内出血斑	内出血
人工呼吸治療に伴う鎮静	医療処置中の鎮静
肝細胞癌（C型）	肝細胞癌
唇裂・口蓋裂	口唇口蓋裂
直腸癌で２００５年に手術	直腸癌
アナフィラキシーショックの疑い	アナフィラキシーショック
帯下異臭	異臭性腟分泌物
右ラクナ梗塞	ラクナ梗塞
心室中隔欠損手術後	心室中隔欠損修復
甲状腺乳頭癌	乳頭様甲状腺癌
頻脈性	頻脈
右眼マイボーム腺梗塞	マイボーム腺梗塞
上行結腸癌→ｏｐｅ	上行結腸の悪性新生物
接触性皮膚炎（顔）	接触皮膚炎
腹腔内リンパ節転移	リンパ節転移
僧帽弁輪形成術術後	僧帽弁修復
胃糜爛	胃粘膜びらん
下血の増悪	メレナ
便秘傾向	便秘
右腎癌	腎癌
立位困難	起立困難
甲状腺右葉切除術	甲状腺葉切除術
冠動脈拡張症	冠動脈拡張
マイクロ波凝固療法	マイクロ波凝固
Ｐａｔ	無し
ｉ‐ＰＴＨが６３０に上昇した	ＰＴＨ増加
左足が痺れる	足のしびれ感
白血球数（末梢血）の上昇	白血球数増加
消退出血時の腰痛	無し
子宮筋腫（全摘術）	筋腫核出術
直腸周囲の脂肪織濃度上昇	脂肪組織増加
下肢ＡＳＯの増悪	下肢閉塞性動脈硬化症
右末梢性顔面麻痺	顔面神経麻痺
いつも頭が重い	頭重
悲観気分	悲哀感
両側腎のう胞	腎嚢胞
右腸骨部湿疹	湿疹
下くちびるが腫れる	口唇腫脹
肝キノウ障害	肝機能障害
右耳下腺癌（平成２４年４月）	耳下腺悪性腫瘍
期限切れのレビトラを処方	期限切れの薬剤使用
原因不明右下肢痛	下肢痛
左下腿内側部痛	下肢痛
血管腫（肝）	肝臓血管腫
多形紅球	多形紅斑
膵コウソ↑	膵酵素増加
犬に噛まれ	イヌ咬傷
３３才～３４才右白内障のｏｐｅ	白内障手術
転倒による臀部打撲【臀部打撲】	殿部の挫傷
大腸癌術后（Ｈ２２年３月ｏｐｅ）	大腸癌
上半身のかゆみ	そう痒
むちうち症	むち打ち損傷
おりものに少し血が混じっている	血性腟分泌物
顔面尋常性いぼ	尋常性疣贅
マヒ	麻痺
悪阻	妊娠悪阻
ヘルペス帯状疱疹	帯状疱疹
ドライブライン感染症	医療機器関連感染
左側頭葉皮質下出血	脳出血
１９９８糖尿病を指摘され治療開始	糖尿病
のう胞性膵疾患	膵嚢胞
掻痒感（右脇腹のカテーテル部位）	カテーテル留置部位そう痒感
心窩部不快	心窩部不快感
両下腿掻痒感	下肢そう痒
左足首ねんざ	足関節捻挫
原疾患の進行による死亡【腎細胞癌】	腎細胞癌
打撲【下肢】	脚の挫傷
ＩＰＡＡ	回腸肛門吻合
慢性肺血栓塞栓症	慢性肺塞栓症
ＣＰＫが上昇	ＣＰＫ増加
下肢乾皮症	乾皮症
脳梗塞領域に微小出血	出血性脳梗塞
夜間失禁	夜尿
痰に少量の血が混じる	血痰
HB低下	ヘモグロビン減少
疼痛増強（骨転移部）	転移部骨痛
背筋の痙攣	背筋攣縮
（早期）胃癌	胃癌
A型肝炎	Ａ型肝炎
肛門管に圧痛	肛門痛
右骨盤骨折	骨盤骨折
両手ピリピリ感	手異常感覚
右胸水穿刺部出血【出血】	穿刺部位出血
消化管間質腫瘍（胃）	消化管間質性腫瘍
Ｓ状結腸癌	Ｓ状結腸の悪性新生物
甲状腺癌（摘術）	甲状腺癌
腸管嚢胞性気腫症	腸壁嚢状気腫症
血清リパーゼ高値	リパーゼ増加
口腔内良性腫瘍術後	口腔の良性新生物
甲状腺眼症（左眼）	甲状腺関連眼窩疾患
両外反母趾	外反母趾
網膜中心静脈分枝閉塞症	網膜静脈閉塞
高血圧症の悪化（頭痛を伴う）【高血圧症の悪化】	高血圧増悪
麦粒腫（右眼）	麦粒腫
汎発性急性湿疹	急性湿疹
ＨａｎｄＦｏｏｔＳｙｎｄｒｏｍ	手足症候群
両手疼痛	手の痛み
硬膜下ＡＤＭ【脳血管動静脈奇形】	脳血管動静脈奇形
のう胞感染	感染性嚢腫
ａｎｇｉｎａ ｐｅｃｔｏｒｉｓ	狭心症
胸がズキズキ痛む	胸痛
風疹感染に関連する関節炎	風疹性関節炎
２００７．１１．１右乳癌術後	乳癌
肝キノウ異常ＧＯＴ↑	ＧＯＴ増加
膣部びらん	腟びらん
最大呼気流速増加	最大呼気流量増加
軟性ドルーゼン	黄斑ドルーゼン
７７才甲状腺腫瘍（良性）	甲状腺の良性新生物
汎網膜光凝固術（右眼）	汎網膜光凝固
尿糖陽転	尿糖陽性
特発性好酸球増多症	好酸球増加症
筋痙攣（手・足）	四肢痙攣
Ｈ９妊娠中毒症	妊娠中毒症
消化管間質腫瘍（腸管外）	消化管間質性腫瘍
薬物相互作用	薬物相互作用
上腕動脈仮性動脈瘤破裂	血管偽動脈瘤破裂
左手首皮下出血	皮下出血
左眼球手術	眼部手術
左膝半月板損傷	半月板損傷
狭心症（ステント後）	狭心症
ふくらはぎの痺れ	下肢のしびれ感
むくみ【両下肢】	下肢浮腫
怪我すると止血しにくい	止血延長
挫傷部の出血（出血）	外傷性出血
サ声	嗄声
両白内障手術	白内障手術
血栓形成予防	血栓症予防
胆のう結石	胆嚢結石
口唇のしびれ	口唇のしびれ感
不安定性膀胱	不安定膀胱
やけど	熱傷
肩部関節痛	肩関節痛
胸膜炎(幼少時)	胸膜炎
腹部皮疹	体幹皮疹
術後性頬部のう腫術後	嚢胞
巨大子宮筋腫	子宮筋腫
進行下部直腸癌	直腸癌
子宮頸部異型上皮異型度１	子宮頚部上皮異形成
コレステロールが高め	コレステロール高値
血清アルブミン値の低下	血清アルブミン減少
タンパク尿の増悪	蛋白尿増悪
ｅｏｓｉｎｏ％の上昇	好酸球百分率増加
息を吸うと胸が痛む	呼吸時疼痛
顔面の発疹（膨隆疹）	限局性蕁麻疹
Ｎａ低下	ナトリウム減少
DM性腸管運動障害	糖尿病性胃腸障害
心房細動アブレーション周術期	心房細動
髪の毛が抜けている	毛髪脱落
右足腱しょう炎	腱鞘炎
義歯の不具合【義歯があわない】	義歯不具合
頻脈性心房細動	頻回心室応答を伴う心房細動
肝動脈血栓	肝動脈血栓症
全身性乾皮症	乾皮症
左下肢浮腫	下肢浮腫
微小肺動脈腫瘍塞栓	腫瘍性塞栓症
γｰGTP高値の悪化	γ－グルタミルトランスフェラーゼ高値
右中咽頭癌頚部転移	無し
左肩～頚部の疼痛	肩痛
足がだるい	筋肉疲労
右前脛骨部骨折	脛骨骨折
左下腿切断術	下肢切断
手掌発赤	手掌紅斑
腎機能の悪化	腎機能悪化
眼瞼かぶれ[コメント欄に次の記載あり：「化粧品による眼瞼の周りのかぶれのため治験薬との関連はない」]	アレルギー性眼瞼炎
発疹（顔、手、足、首）	発疹
腰椎不安定症L4 L5	腰椎不安定
息切れ・呼吸困難	呼吸困難
左萎縮腎	萎縮腎
右眼黄斑穿孔	黄斑破裂
右大腿部筋肉炎	筋炎
嘔気、食欲不振	無し
ａＰＴＴ過度高値	ＡＰＴＴ増加
突然死【詳細不明】	突然死ＮＯＳ
甲状腺数値異常	甲状腺機能検査異常
両側手根管症候群	手根管症候群
黄色い痰	変色痰
頭の痒み	頭皮そう痒
腸破裂（交通事故による）	無し
全身の腫脹感	腫脹ＮＯＳ
喉のいがいが	咽頭刺激感
両老人性白内障	老人性白内障
尿蛋白（＋）	尿蛋白陽性
全身のだるさ	全身倦怠
皮下腫瘍（左側腹部、左腋窩）	皮膚腫瘍
ヒフそうよう症	皮膚そう痒症
左右変形性膝関節症	変形性膝関節症
インフルエンザ感染	インフルエンザ
骨、肺肝転移【骨転移】	骨転移
原因不明の腎機能低下症	腎機能低下
子宮頚部細胞診（トリコモナスチェックのため）の性器出血	処置による出血
湿疹（会陰部）	湿疹
乳房の張り感	乳房緊満
イグザレルトを１日５ｍｇ服用	不完全な用量の投与
右腎嚢胞	腎嚢胞
口腔のあれ	口内のあれ
骨移植術	骨移植
右頬口腔粘膜血腫	口腔粘膜血腫
右網膜剥離手術	網膜剥離修復
肝機能障害の疑い	肝機能障害
陳旧性子宮筋腫	子宮筋腫
黄斑下手術（右眼）	網膜手術
続発性副甲状腺亢進症	続発性副甲状腺機能亢進症
月経が１週間遅れた	月経遅延
両眼黄斑浮腫	黄斑浮腫
左腎結石仙痛発作	無し
心筋こうそく	心筋梗塞
大腸癌肝転移	無し
頻繁なＵＴＩ	反復性尿路感染
２００８２／２０副腎不全	副腎機能不全
変形性肘関節症疑い	変形性肘関節症
右手根管手術	手根管減圧術
左足底に痺れ	足のしびれ感
上いんとう癌	上咽頭癌
ロイシンアミノぺプチダーゼ上昇	ロイシンアミノペプチダーゼ上昇
穿刺部のかぶれ	接触皮膚炎
細菌性肺炎の再燃	細菌性肺炎
脳幹梗塞後遺症	脳幹梗塞
ムコソルバンは、ｏｐｅ後の去痰目的	痰
術後腸管癒着（腸管癒着でOK）	腸管癒着
左側肢神経痛	神経痛
血栓症の予防	血栓症予防
プラダーウィリー症候群	プラダーウィリ症候群
生理が来ない	月経遅延
心不全様症状	心不全
糖尿病性綱膜症	糖尿病網膜症
運動性失語	運動性失語症
カンジダ【腟（外陰部）】	外陰部腟カンジダ
HCV陽性	Ｃ型肝炎ウイルス検査陽性
急性心不全疑い	急性心不全
肺癌抗がん剤治療	肺癌
右上腕乾皮症	乾皮症
子宮筋腫（子宮摘出術施行）	筋腫核出術
果物によるアレルギー	果物アレルギー
アルコール歴有	アルコール摂取
眼底出血（硝子体出血）	無し
網膜剥離術後	網膜剥離修復
肝機能障害出現	肝機能障害
そけいヘルニア手術	鼡径部ヘルニア修復
後腹膜腫瘍	後腹膜新生物
アミラーゼ低下	アミラーゼ減少
下腹部痛（内膜細胞診採取のため）	処置による疼痛
美出血	鼻出血
痛風関節炎	痛風性関節炎
手足皮フ反応	手足皮膚反応
２型糖尿病性腎症	糖尿病性腎症
左石灰沈着性腱板炎	肩の石灰化腱炎
子供が偶発的に祖母の薬を服薬した	子供の偶発的薬剤摂取
チャンバー凝固	体外回路内血液凝固
高熱（３８℃）	発熱
頭部過敏症状	皮膚過敏症
Ｓ状結腸拡張症	結腸拡張
声がでずらい	発声困難
肉眼的血尿の悪化	肉眼的血尿
精神状態悪化予防	予防
むねやけ	胸やけ
両大腿骨骨折	大腿骨骨折
Ｔ－Ｂｉｌ増加【総ビリルビン増加】	総ビリルビン増加
血栓再発抑制	血栓症予防
嘔吐（月経時）	嘔吐
急性歯槽骨炎	歯槽骨炎
非弁膜性発作性心房細動	発作性心房細動
左下肢蜂窩織炎	下肢蜂巣炎
陳旧性ラクナ梗塞（脳）	ラクナ梗塞
細菌性多発肺炎	細菌性肺炎
合成ペニシリンアレルギー	ペニシリンアレルギー
Ｐ－ＡＭＹ上昇	血中膵型アミラーゼ増加
左右下肢静脈瘤	下肢静脈瘤
陥入爪の悪化	嵌入爪
発赤（左母指）	限局性紅斑
早期糖尿病性腎症	糖尿病性腎症
血色素量減少	ヘモグロビン減少
前立腺肥大に伴う排尿困難	無し
下腿切断	下肢切断
眼けん湿疹	眼瞼湿疹
右下腿内出血	無し
低Ｈｂ	ヘモグロビン低値
一過性腎障害（薬剤性：ＣＤＤＰ）	腎障害
右肋間痛	肋間痛
肝機能検査値上昇（ビリルビン）	ビリルビン増加
右足がつる	こむら返り
穿刺部周囲掻痒感	血管穿刺部位そう痒感
喉の閉塞感	喉頭不快感
認知症の悪化	認知症増悪
陰嚢皮膚炎	皮膚炎
３前装鋳造冠脱離【歯科補てつ物破損】	歯科補てつ物破損
尿潜血（+）	尿潜血陽性
ステント血栓症	血管ステント血栓症
内シャント穿刺部皮下血腫	静脈穿刺部位出血
咳嗽増強	咳嗽増悪
乳腺の痛み	乳房痛
限局性肥大型心筋症	肥大型心筋症
手の痒み	限局性そう痒
四肢末端発赤	皮膚発赤
腸閉塞様症状	腸閉塞
咽頭炎疑い	咽頭炎
肥満症	肥満
生理の出血が多い	月経過多
横行結腸の大腸ポリープ	結腸ポリープ
両手関節のこわばり	関節硬直
５２才糖尿病	糖尿病
背中～頭部痛	背部痛
左眼充血	眼充血
3.緑内障	緑内障
左卵巣癒着	卵巣癒着
手足のむくみ	四肢浮腫
出血性の脳卒中	出血性卒中
ａｐｐｅｎｄｅｃｔｏｍｙ	虫垂切除
肺がん手術後胸部痛	無し
シャント肢打撲【上腕】	上腕の挫傷
左足第１趾．第５趾骨折	趾骨折
慢性硬膜下血腫の合併	慢性硬膜下血腫
腰痛（子宮内膜細胞診による）	処置による疼痛
擦過傷（上口唇）	擦過傷
右前腕腫脹	腕の腫脹
非外傷性クモ膜下出血	くも膜下出血
ＴＧの上昇	トリグリセリド増加
ＡＬＴ／ＡＳＴ上昇	無し
高ＣＫ血症の悪化	クレアチンキナーゼ高値
多発骨転移	骨転移
紅疹（紅斑性皮疹）	紅斑性皮疹
便潜血陽性、大腸出血	大腸出血
ブドウ膜炎	ぶどう膜炎
手足皮膚反応（抗癌反応）	手足皮膚反応
全身皮脂欠乏性湿疹	皮脂欠乏性湿疹
点状紫斑	紫斑
血腫増大	血腫
下行結腸ガン	下行結腸癌
癌の進行による死	癌
発熱性好中球減少	発熱性好中球減少症
RIGHT KIDNAY CANCER	腎癌
頚性眩暈	頚原性回転性めまい
疲労感増強	疲労増悪
心弁膜症手術	心臓弁膜症
けん怠	倦怠感
月経量が多い	月経過多
十二指腸水平脚憩室出血	出血性腸憩室
左頭頂葉皮質下出血	脳出血
結膜出血（右）	結膜出血
一過性性心房細動	心房細動
フォンタン手術（心房－肺動脈吻合）	体循環肺動脈シャント
下肢急性動脈閉塞症	末梢動脈閉塞
Ｉ型呼吸不全	呼吸不全
脂質異常ｊ症	脂質異常症
ＩＣＤ電池交換手術のための入院	心臓ペースメーカーバッテリー交換
感染徴候（＋）	感染
乳頭状腫瘤（直腸）	直腸腫瘤
右耳の拍動性雑音	拍動性耳鳴
痛風（４２才時）	痛風
出血（喀血）	喀血
飲酒の習慣あり	アルコール摂取
全身転移	転移
大腸ガン術後	大腸癌
原疾患の進行【切除不能な肝細胞癌】	肝細胞癌
体液貯瘤	体液貯留
右手首の腫脹	手関節腫脹
右上葉肺癌	肺癌
下腿皮膚潰瘍の悪化	下腿潰瘍
肺高血圧の持続的悪化による経皮経管肺動脈血行再建術	肺高血圧症増悪
Ｔ－Ｂｉｌ上昇（総ビリルビン上昇）	総ビリルビン増加
一時心肺停止	心肺停止
５３才右下肢蜂窩織炎	下肢蜂巣炎
かかとに違和感	足部不快感
透析中下肢筋ケイレン	下肢痙攣
前立腺肥大症２００６年４月よりハルナール投与中	前立腺肥大症
「６根尖性歯周炎	根尖性歯周炎
おりもの増加	腟分泌物異常
脂肪腫（疑）	脂肪腫
注射部位に疼痛	注射部位疼痛
凝固系検査値異常変動（プラスミノーゲン上昇；Ｄダイマー上昇；プロテインＳ低下）	無し
ＣＲＰ値上昇	ＣＲＰ増加
２２ｙＴｂ（結核）	結核
認知症に伴う不穏	無し
倦怠感の悪化	倦怠感
高アルカリホスファターゼ (血中アルカリホスファターゼ増加)	血中アルカリホスファターゼ増加
卵巣摘出術	卵巣摘除
HEADACHE	頭痛
ｈａｎｄ－ｆｏｏｔ	無し
第１頚椎左外側塊骨折	脊椎骨折
薬物相互作用によるＩＮＲ値の延長	無し
PT-INR値が高値	ＩＮＲ増加
せん妄	譫妄
Ｈｔ値低下	無し
手足反応【手足皮膚反応】	手足皮膚反応
右外果粉砕骨折	足関節部骨折
慢性腎臓病の悪化	慢性腎不全増悪
Ｂ群Β溶血性レンサ球菌陰性	Ｂ群β溶血性レンサ球菌陰性
噴門側胃切除	胃部分切除
右足第１趾疼痛	足指痛
入院時の胃潰瘍防止	胃潰瘍予防
急性中毒疹（多形紅斑型）	無し
イマチニブ関連Ｓ／Ｏ心不全	心不全
補助化学療法	化学療法
腹部出血	腹腔内出血
腸ゆ着乖離術	腸管癒着部剥離
下部胆管癌	胆管癌
右眼網膜静脈閉塞症	網膜静脈閉塞
高トリグリセライド血症の増悪	高トリグリセリド血症
肝機能異常ＧＯＴ↑	ＧＯＴ増加
肝細胞癌（２００７．５．２９）	肝細胞癌
意欲低下	意欲減退
陳旧性肋骨骨折	肋骨骨折
性器出血（細胞診によるもの）	処置による出血
完全房室ブロック（ペースメーカー植え込み術後）	完全房室ブロック
創部術後感染	術後創感染
心臓-その他(虚血性心疾患)	虚血性心疾患
網膜静脈分岐閉塞症	網膜静脈分枝閉塞
ヘリコバクター・ピロリ感染症	ヘリコバクター・ピロリ感染
擦窩傷	擦過傷
口蓋乳頭腫	口腔乳頭腫
胆嚢癌により死亡	胆嚢癌
足の皮膚(ひざから下)の皮膚疾患(潰瘍)	足の潰瘍
胃切除後巨赤芽球貧血	巨赤芽球性貧血
めまい低血圧	無し
軽度鬱状態	抑うつ状態
生卵、鶏肉で発疹	アレルギー性皮疹
Ｈ１９年８月１日、左腎細胞がんにてｏｐｅ	腎細胞癌
体部皮脂欠乏性湿疹	皮脂欠乏性湿疹
下肢静脈瘤バイアスピリン内服	下肢静脈瘤
しっしん【湿疹】	湿疹
先行疾患ＮＯＳ	先行疾患
全身自家感作性皮膚炎	自家感作性皮膚炎
脳梗塞時期不明	脳梗塞
先天性知的障害	知的能力障害
（舌が痛い）口内炎	無し
術後吻合部出血	吻合部出血
めまい症の悪化	めまい増悪
１錠飲み忘れ	投薬欠落
右肩皮下出血	皮下出血
生理が7日間早まった	月経周期短縮
服用を忘れた	投薬欠落
肝膿瘍増悪	肝膿瘍
後頚部毛嚢炎	毛包炎
Ｌ３／４椎間板ヘルニア	腰椎椎間板ヘルニア
胃癌ＯＰ	胃癌
右乳癌Ｈ１４	乳癌
初老期妄想状態	妄想状態
便通回数増加	排便回数増加
白血球数増	白血球数増加
眼瞼下垂（右）	眼瞼下垂
糖尿病末梢神経障害	糖尿病性末梢性ニューロパチー
肝癌－Ｈ１８．６月動注塞栓術	肝癌
